7 7
# # # # # # #
# . . . . . #
# . A a . . #
# . # # . . #
# . . @ . . #
# . . . . . #
# # # # # # #
