16 13
#############
#...........#
#....G......#
#...........#
#..#####.G..#
#..#...#....#
#....@......#
#..#...#....#
#..#####....#
#.......a...#
#.....A.....#
#...###.G...#
#..G........#
#....####G..#
#...........#
#############
