14 17
#################
#.G.....a.....G.#
#....G.....G....#
#...............#
#...............#
#...............#
#....#######....#
#.##.........##.#
#...............#
#...###.A.###...#
#...............#
#.......@.......#
#...............#
#################