8 12
....#...#...
.a..#.@.#.a.
....#...#...
....#AAA#...
............
....#...#...
....#.a.#...
....#...#.G.
