15 15
###############
#.G.......a...#
#.............#
#.....A.......#
#.............#
#......a......#
#.a.#######.A.#
#.............#
#...a.........#
#...........G.#
#.............#
#..###.A.###A.#
#..@..........#
#.............#
###############