12 12
############
#.G.......a#
#......a...#
#.a.########
#..........#
#...a...G..#
#..........#
#..........#
#.A###AAA###
#..@.......#
#..........#
############