14 17
#################
#.....a...a.... .#
#.....G...G.....#
#...............#
#..###.....###..#
#..#.........#..#
#..#.###.###.#..#
#..#.#.....#.#..#
#..#.#.A@A.#.#..#
#..#.#.....#.#..#
#..#.###.###.#..#
#...............#
#.G...........G.#
#################
