12 20
####################
#..G..............G#
#..................#
#..#####....#####..#
#..#...#....#...#..#
#..#.A...aa...A.#..#
#..#...#....#...#..#
#..#####....#####..#
#..................#
#....G......@......#
#..................#
####################
