10 14
##############
#a..#.@.#.a..#
#...#...#....#
#...#AAA#....#
#............#
#...#...#....#
#...#.a.#....#
#...#...#.G..#
#.G..........#
##############