7 7
# # # # # # #
# G . . . . #
# . A a . . #
# . # # . . #
# . . @ . . #
# . . . . . #
# # # # # # #
