8 8
# # # # # # # #
# . . . . . . #
# . A . . a . #
# . . # # . . #
# . . . @ . . #
# . . . . . . #
# . . . . . G #
# # # # # # # #
